10,12,13,13,15,15,16,17,16,16,17,17,16,16,15,14,14,15,14,14,14,15,15,16,16,16,16,17,17,17,17,16,17,17,17,17,17,16,16,17,17,17,18,17,17,17,16,15,15,14
11,13,14,15,17,17,17,18,18,18,18,17,18,17,17,16,15,16,15,15,15,15,16,16,17,17,17,17,17,18,18,18,18,18,18,17,17,17,17,18,18,18,19,18,18,18,17,16,15,14
12,13,15,16,18,18,19,19,20,20,19,19,19,18,18,17,16,17,16,16,16,16,17,17,17,18,18,18,18,18,18,18,18,18,18,19,19,19,19,18,19,19,20,19,19,18,18,17,16,15
13,15,17,18,20,20,20,20,20,20,20,20,19,19,19,18,17,18,17,17,17,17,17,18,18,18,18,18,18,19,19,19,19,19,19,19,19,19,19,19,20,20,21,20,20,19,18,17,16,15
13,15,17,19,21,21,21,21,21,21,20,20,20,20,20,19,18,19,18,18,18,18,18,18,18,19,19,19,19,19,19,19,19,19,19,19,19,19,19,19,20,21,22,21,20,19,18,17,16,15
14,16,18,20,21,22,22,22,22,22,22,22,22,22,21,21,20,20,19,19,19,20,20,20,20,20,20,20,20,20,20,20,20,20,20,20,20,20,20,20,21,22,22,22,21,20,19,18,17,16
13,15,17,19,21,21,21,21,21,21,21,21,21,21,21,21,20,21,20,20,19,19,19,19,19,19,19,19,19,19,19,19,19,19,19,19,19,19,19,19,20,21,22,21,20,19,18,17,16,15
13,15,17,18,20,20,21,21,21,21,21,21,21,21,21,21,21,22,21,20,19,19,19,19,19,19,19,19,19,19,19,19,19,19,19,19,19,19,19,19,20,20,21,20,20,19,18,17,16,15
14,15,17,18,20,20,21,21,23,22,22,22,22,22,22,22,22,22,22,21,20,20,20,20,20,20,20,20,20,20,20,20,20,20,20,20,20,20,20,19,19,19,20,19,19,18,18,17,16,15
12,14,15,16,18,19,20,21,22,21,21,21,21,21,21,21,21,22,21,20,19,19,19,19,19,19,19,19,19,19,19,19,19,19,19,18,18,18,18,18,18,18,19,18,18,18,17,16,15,14
11,13,14,16,18,19,20,21,22,21,22,22,21,22,20,20,20,21,20,20,19,19,19,19,19,19,19,19,19,19,19,18,18,18,18,18,18,17,17,17,17,17,18,17,17,17,16,15,15,14
10,12,14,15,18,19,20,21,23,23,23,23,23,23,21,20,20,21,20,19,18,19,19,19,19,18,18,18,18,18,18,18,18,18,18,17,17,17,16,16,16,16,17,16,16,16,15,15,14,13
9,11,13,15,18,19,21,22,24,24,23,24,23,23,21,20,20,21,20,19,19,17,17,17,17,18,18,18,18,18,18,17,17,17,17,17,16,16,15,15,15,15,16,15,15,16,14,14,13,13
9,11,13,15,18,19,20,22,24,24,25,24,23,23,22,21,20,21,19,19,18,17,16,17,17,17,17,17,16,17,17,17,17,16,16,16,16,15,15,14,15,15,16,15,15,16,15,14,14,13
7,9,11,13,17,19,21,23,25,25,25,24,23,23,22,21,20,21,19,19,18,17,17,15,15,16,16,16,16,16,16,15,15,15,14,15,15,14,14,14,14,15,16,15,15,16,15,14,14,14
6,8,10,13,17,18,20,23,25,25,25,23,23,23,22,21,20,21,19,19,18,16,16,15,15,15,15,14,14,15,15,15,14,14,14,13,13,13,13,14,14,15,16,15,15,17,16,15,15,15
6,8,11,13,16,18,21,24,25,25,25,25,24,25,23,22,21,21,19,19,18,17,15,16,14,13,13,14,14,13,13,13,14,13,13,12,13,12,13,14,14,15,16,16,16,18,17,16,16,16
3,6,8,12,16,18,20,22,26,24,25,25,24,25,22,21,20,20,19,18,18,17,15,14,13,13,13,12,12,13,13,12,12,12,11,12,11,13,13,14,14,15,17,17,17,19,18,18,17,18
4,7,9,13,16,19,21,22,26,25,26,26,25,26,23,22,21,20,19,18,17,17,15,14,12,12,11,11,11,11,11,10,10,11,10,11,11,12,13,13,14,15,18,18,18,20,19,19,18,18
4,8,10,14,16,18,21,23,25,25,26,26,26,27,24,23,21,21,18,18,17,16,14,13,11,11,10,10,10,9,9,10,9,9,9,10,11,12,12,13,15,16,19,18,19,20,20,20,19,19
5,8,10,14,17,20,20,22,26,25,27,27,27,27,24,23,22,22,19,17,16,16,15,13,12,10,10,8,8,9,8,8,7,9,9,9,9,11,12,14,15,17,19,19,21,21,21,21,20,20
5,8,11,13,16,19,20,22,26,25,26,27,27,27,25,24,22,23,20,18,17,15,14,12,11,9,8,7,6,7,7,6,7,7,8,8,9,12,12,14,16,18,21,21,22,23,23,23,22,22
5,7,10,13,15,18,20,21,25,24,26,27,27,27,25,24,23,22,20,18,16,14,13,11,10,8,7,5,5,5,5,5,5,5,7,8,9,13,14,16,18,20,21,22,24,25,25,25,23,24
6,8,10,12,15,17,19,20,24,24,25,26,27,27,26,24,23,22,19,18,16,14,12,10,9,8,6,4,4,3,4,3,5,6,8,9,11,14,15,17,19,21,24,24,26,27,26,27,26,25
7,9,12,13,16,18,19,21,24,24,25,26,28,27,27,25,23,23,20,18,17,15,13,10,9,8,6,5,3,3,3,4,5,6,9,10,12,15,16,18,20,22,24,25,27,28,28,28,27,26
7,9,11,12,15,17,18,20,22,23,24,25,27,27,26,24,22,21,19,17,15,13,11,9,7,6,4,3,3,4,4,4,6,9,11,12,14,17,18,20,22,24,26,27,29,29,29,29,29,28
8,10,11,13,14,17,18,20,22,23,24,26,25,26,24,24,22,21,18,16,15,13,11,9,6,5,3,3,3,4,5,6,7,9,10,12,14,17,19,21,23,25,27,28,30,30,30,29,29,27
9,10,12,14,15,17,19,20,22,23,23,25,24,25,23,22,21,21,18,16,14,12,10,8,5,4,3,4,4,5,6,8,8,11,12,14,15,17,19,21,23,25,27,28,29,29,28,29,28,28
9,11,13,14,16,18,18,19,22,22,23,24,23,23,22,21,20,19,16,14,13,12,10,8,6,4,4,3,5,7,8,9,10,12,14,16,17,19,21,23,25,26,27,28,30,30,29,29,27,28
10,11,12,14,16,18,19,20,21,21,22,23,22,22,20,19,19,18,15,14,12,10,8,7,4,4,5,5,7,9,9,11,12,14,16,18,19,21,22,24,26,27,29,29,30,31,29,29,28,27
9,11,13,15,17,18,19,20,22,21,22,21,21,21,19,18,17,16,14,12,10,9,7,6,5,5,4,6,8,9,11,12,13,16,17,18,20,22,24,26,27,28,28,29,30,30,29,28,27,27
9,11,12,14,16,18,20,20,22,21,22,21,20,20,18,17,16,14,13,11,10,8,7,6,5,5,6,8,9,11,12,13,15,16,19,20,22,24,24,26,28,28,29,29,29,30,29,28,27,26
9,10,12,14,15,17,19,21,22,22,21,20,19,19,17,16,15,14,12,11,9,8,7,6,5,5,7,8,10,12,13,15,17,18,19,21,23,25,25,27,28,29,29,29,30,29,28,27,26,25
10,11,12,14,16,17,19,21,21,22,21,20,19,19,17,16,15,14,12,11,10,8,8,7,6,7,7,9,11,13,14,16,18,19,21,23,24,26,26,28,28,29,29,28,29,28,27,26,25,25
9,10,11,12,14,16,17,19,20,20,19,18,17,17,15,14,13,12,10,9,8,8,7,6,6,6,8,10,12,13,15,17,18,20,21,23,26,27,27,28,27,28,28,28,28,28,26,25,24,24
9,10,11,12,13,15,16,17,18,18,18,17,16,16,14,13,12,11,9,9,8,8,6,6,7,8,10,11,13,15,17,18,20,22,23,25,26,28,28,29,28,28,28,28,28,28,26,25,24,24
9,10,11,12,13,13,15,15,17,16,16,15,15,15,13,12,11,10,9,8,8,7,7,7,7,7,9,11,13,15,16,18,20,21,23,25,26,28,27,28,27,27,26,26,26,26,24,23,22,22
9,9,10,11,12,13,13,13,15,14,14,14,13,13,11,10,10,9,9,8,8,8,7,7,7,8,10,12,14,15,17,19,21,22,24,26,26,28,27,28,28,27,26,25,25,25,23,22,21,21
8,9,10,10,11,12,12,12,13,12,12,12,11,11,10,9,8,7,7,7,8,8,8,8,8,9,10,12,14,16,18,19,21,23,24,25,26,27,27,27,27,27,26,25,25,24,22,21,20,19
8,8,9,10,10,11,11,11,12,11,11,11,10,10,9,8,8,8,8,8,8,7,7,7,7,9,11,13,15,16,17,19,21,23,24,25,26,27,27,27,28,27,26,25,25,24,23,22,21,19
7,8,8,9,9,10,10,10,11,10,10,10,9,9,8,8,7,7,7,7,8,8,8,8,8,9,10,12,14,16,18,20,21,22,24,25,25,27,27,27,28,27,26,26,26,24,23,22,21,20
6,7,8,8,9,9,9,9,10,9,9,9,9,8,8,7,6,6,7,7,7,7,7,8,8,9,11,13,15,17,17,19,21,22,24,24,25,27,27,27,28,27,27,26,26,25,24,23,22,20
5,6,7,7,8,8,8,8,9,8,8,8,8,7,7,6,6,7,7,7,8,7,7,7,8,9,10,12,14,16,18,19,21,21,23,24,25,27,26,27,27,27,27,26,27,25,24,23,21,21
5,5,6,6,7,7,7,7,8,7,7,7,7,6,6,5,6,6,6,7,7,7,7,8,9,10,11,12,13,15,17,19,20,22,23,24,25,26,26,27,27,28,27,27,27,25,24,24,22,22
4,4,5,5,6,6,6,6,7,6,6,6,6,5,5,4,5,5,6,6,6,6,7,8,9,10,11,12,14,15,17,19,20,21,22,23,24,26,26,26,27,28,27,27,27,25,25,24,23,22
3,4,4,5,5,5,5,5,6,5,5,5,5,5,4,4,4,5,5,5,6,6,7,8,9,10,11,12,13,15,16,18,19,21,22,23,24,25,25,26,27,28,27,27,27,26,25,25,24,23
2,3,3,4,4,4,4,4,5,4,4,4,4,4,3,3,3,4,4,4,5,6,7,8,9,10,11,12,13,14,15,17,18,20,21,22,23,25,25,26,27,27,27,27,27,26,26,25,25,24
1,2,2,3,3,3,3,3,4,3,3,3,3,3,2,2,2,3,3,4,5,6,7,8,9,10,11,12,13,14,15,16,18,19,20,21,22,24,24,25,26,27,28,27,28,27,27,26,25,24
1,1,1,2,2,2,2,2,3,2,2,2,2,2,1,1,2,2,3,4,5,6,7,8,9,10,11,12,13,14,15,16,17,18,19,20,21,23,23,24,25,26,27,28,29,28,27,26,25,24
0,0,0,1,1,1,1,1,2,1,1,1,1,1,0,1,2,3,4,5,6,7,8,9,10,11,12,13,14,15,16,17,18,19,20,21,22,23,24,25,26,27,28,29,29,29,28,27,26,25
